10
31
20
0000000344444444412222222323133
6666660000000000000000000044233
0000000000000000000000000004233
1144444444444333222233000000411
1144444432323232323232320000011
1132322222222232323232322000044
1133322221122222222333333000044
1133321112211122222222333000022
1112311223333133112222200000222
1101111000000775232323000003333
1100000000000666222233110000333
1100002222333333333131111000033
1100002222233331222222211000033
1100001222222444442223311000111
1110002222333133332244111001111
1100002222222244443333311000111
1100002222222444133333111000011
1100000000000000000000000000011
1100002223300000000000233000011
1123232323232323232323232323211