10
31
20
3333333333333111114444433344444
3333333333333221144444434444444
1333333333322222224444414444444
1113333333322222224411111444444
1111333333222222224111114444775
1111133330222222224111114000666
1111111100022222224111144000000
0111111000000222224111440000000
0000000000000000004444400000000
0000000000000000000000000000000
6666660000000000000000000000111
0000000000000000000000000004111
0000001111111111100000000444444
0000011111111111110000004444444
3333331111111111100000044444444
3333331111111111000000044444444
3333331111111100000000044444444
3333333111110000000000004444444
3333333222220000000000004444444
3333332222220000002000044444444