10
31
20
2222222221111144444333411111111
2222222222233221144444434441111
1333333333322222224444414444444
0000000000032222222441111111111
0000000000000222224111111111111
6666660000000000333333333333333
0000000000000002224111143333333
0000000000000222224111333333333
0000000000000000004444411111111
0000000000000000000011111111111
0000000000000000000000000000111
4444400000000000000000000004111
4444444444000000000000000444444
1111444444444000000000004444444
3333331110000000000000000000775
3333331111111111000000000000666
4444441111111100000000033333333
4444444111111111111111113333333
4444444222221111111111113333333
4444442222222222222222244443333